NO ./textures/NO.xpm
SO ./textures/SO.xpm
WE ./textures/WE.xpm
EA ./textures/EA.xpm

C 30, 30, 100
F 127, 127, 127

1111111
1000001
100N001
1000001
1111111
